Map:
------------
------------
-qqqqqqqqqq-
-qqqqqqqqqq-
-111----111-
-111-##-111-
-111-22-111-
-111-##-111-
-111----111-
-##########-
-##########-
------------
------------
------------
------------
------------
------------
------------
------------
------------
------------
------------
------------
------------
------------
Map/

Meta:
Name: LEVEL 1
Time: 300
Hardened: #
PowerUp: 2
Meta/

Legend:
#) teal-block.png
1) blue-block.png
2) green-block.png
q) darkgreen-block.png
Legend/